################
#        O     #
#   P    #######
#           #
#######  X  #
#  O ##     #
#    ##     #
#    X      #
#    X    X #
#       O#  #
######### O #
        #####
