#######
###   #
#OPX  #
### XO#
#O##X ##
# # O ##
#XOXXXO#
#   O  #
########
