#######
###   #
#OPX X#
### XO#
# # XO#
#OX  O#
#######